a fork in the road
===
#: wall
p: player
.: empty
e: exit_anchor
X: spikes
^: onewayup
===
left: 2
up: 5
right: 6
===
################e..#####
e..................#####
...................#####
...........^^^^^^^^#####
...................#####
..p................#####
########...............e
########................
########................
########XXXXXXXXX#######
########################
