the key
===
#: wall
p: player
.: empty
e: exit_anchor
X: spikes
^: onewayup
>: onewayright
r: redkey
===
down: 4
===
########################
#......................#
#......................#
#......................#
#...#####..............#
#...#X.................#
#...#X.................#
#...#X........^^^......#
#...#X.................#
#...#X.................#
#...#X.................#
#...>..................#
#.r.>.......###........#
#...>....p..###XXXXXXXX#
#####e.^################
