doubled jump
===
#: wall
p: player
.: empty
e: exit_anchor
^: onewayup
S: wall4
@: jumparrow
===
left: start
right: crystal
===
########################################
########################################
########################################
########################################
#####..............#####################
#####..............#####################
#####..............................#####
#####..............................#####
#####..............................#####
#####..............................#####
e......................................e
........................................
..............@.........................
........................................
..p......##^^^^^^^......................
#####....##......................SS#####
#####....##......................SS#####
#####....##......................SS#####
#####............................SS#####
#####............................SS#####
########################################
########################################
########################################
